12 12 1
-- -- -- -- -- -- -- -- -- -- -- --
-- -- -- -- -- W1 -- W3 -- -- -- --
-- -- -- -- -- -- -- -- -- -- -- --
-- O2 -- W3 W1 -- -- -- -- -- W2 --
-- -- -- -- -- -- -- -- -- -- -- --
-- -- -- -- -- -- -- -- R -- -- --
-- OO2 -- W1 W3 -- -- -- -- -- W4 --
-- -- -- -- -- W2 -- W4 P1 -- -- --
-- -- -- -- -- W4 -- W2 -- -- -- --
-- -- -- -- -- -- -- -- -- -- -- --
-- -- -- -- -- OO -- O -- -- -- --
-- -- -- -- -- -- -- -- -- -- -- --
-- -- -- -- -- -- -- -- -- -- -- --

