1 1 1 1 1 1 1 1 1 1 1 1
1 1 1 1 1 1 1 1 1 1 1 1
1 1 1 1 1 1 1 1 1 1 1 1
1 1 1 H 1 1 1 1 1 1 1 1
1 1 1 1 1 W1 1 1 1 1 1 1
1 1 1 R 1 LV,P,LH,1 1 C3 1 F 1 LV
1 1 1 1 1 W1 1 1 1 1 1 LV
1 1 RC RCC 1 1 1 1 1 1 1 LV
1 1 1 1 1 1 1 1 1 1 1 LV
1 1 1 LH LH LH LH 1 1 1 1 1
1 1 1 1 1 1 1 1 1 1 1 1
1 1 1 D1 D2 D3 D4 1 1 1 1 1
