12 12 1
1 1 1 1 1 1 1 1 1 1 1 1
1 1 C1 C1 C1 C1 C1 1 1 1 1 1
1 1 1 1 1 1 1 1 1 1 1 1
1 1 1 H 1 P2 1 1 1 1 1 1
1 1 1 1 1 1 1 1 1 1 1 1
1 1 1 R 1 P3 1 C3 1 F 1 1
1 1 1 1 1 1 1 1 1 1 1 1
1 1 1 1 1 1 1 1 1 1 1 1
1 1 1 1 1 1 1 1 1 1 1 1
1 1 1 1 1 1 1 1 1 1 1 1
1 1 1 1 1 1 1 1 1 1 1 1
1 1 1 1 1 1 1 1 1 1 1 1
