6 6 1
-- -- -- -- -- --
-- -- -- -- -- --
-- -- G1 -- G2 --
-- -- P1 -- -- --
-- -- G2 -- G1 --
-- -- -- -- -- --
